BBBBBBBBB
BTTTRTTTB
BTTTRTTTB
BRRRRRRRB
BTTTRTTTB
BTTTRTTTB
BTTTCTTTB
BTTTTTTTB
BBBBBBBBB